"filename", "language", "C++", "JavaScript", "JSON", "Makefile", "comment", "blank", "total"
"c:\Temp\Study\6 semestr\Kurs\Kurs\api.cpp", "C++", 11, 0, 0, 0, 0, 5, 16
"c:\Temp\Study\6 semestr\Kurs\Kurs\api.h", "C++", 17, 0, 0, 0, 0, 7, 24
"c:\Temp\Study\6 semestr\Kurs\Kurs\arrow.cpp", "C++", 92, 0, 0, 0, 63, 18, 173
"c:\Temp\Study\6 semestr\Kurs\Kurs\arrow.h", "C++", 40, 0, 0, 0, 51, 11, 102
"c:\Temp\Study\6 semestr\Kurs\Kurs\basedblocksetting.cpp", "C++", 50, 0, 0, 0, 0, 14, 64
"c:\Temp\Study\6 semestr\Kurs\Kurs\basedblocksetting.h", "C++", 33, 0, 0, 0, 0, 6, 39
"c:\Temp\Study\6 semestr\Kurs\Kurs\basedblockwindow.cpp", "C++", 121, 0, 0, 0, 0, 17, 138
"c:\Temp\Study\6 semestr\Kurs\Kurs\basedblockwindow.h", "C++", 39, 0, 0, 0, 0, 14, 53
"c:\Temp\Study\6 semestr\Kurs\Kurs\compositeblocksetting.cpp", "C++", 11, 0, 0, 0, 0, 8, 19
"c:\Temp\Study\6 semestr\Kurs\Kurs\compositeblocksetting.h", "C++", 22, 0, 0, 0, 0, 6, 28
"c:\Temp\Study\6 semestr\Kurs\Kurs\compositeblockwindow.cpp", "C++", 173, 0, 0, 0, 3, 29, 205
"c:\Temp\Study\6 semestr\Kurs\Kurs\compositeblockwindow.h", "C++", 30, 0, 0, 0, 0, 7, 37
"c:\Temp\Study\6 semestr\Kurs\Kurs\diagramitem.cpp", "C++", 94, 0, 0, 0, 63, 19, 176
"c:\Temp\Study\6 semestr\Kurs\Kurs\diagramitem.h", "C++", 42, 0, 0, 0, 51, 10, 103
"c:\Temp\Study\6 semestr\Kurs\Kurs\diagramitembased.cpp", "C++", 83, 0, 0, 0, 0, 21, 104
"c:\Temp\Study\6 semestr\Kurs\Kurs\diagramitembased.h", "C++", 39, 0, 0, 0, 0, 7, 46
"c:\Temp\Study\6 semestr\Kurs\Kurs\diagramitemcomposite.cpp", "C++", 21, 0, 0, 0, 0, 4, 25
"c:\Temp\Study\6 semestr\Kurs\Kurs\diagramitemcomposite.h", "C++", 14, 0, 0, 0, 1, 6, 21
"c:\Temp\Study\6 semestr\Kurs\Kurs\diagramitemsparql.cpp", "C++", 46, 0, 0, 0, 2, 12, 60
"c:\Temp\Study\6 semestr\Kurs\Kurs\diagramitemsparql.h", "C++", 25, 0, 0, 0, 0, 8, 33
"c:\Temp\Study\6 semestr\Kurs\Kurs\diagramscene.cpp", "C++", 195, 0, 0, 0, 77, 24, 296
"c:\Temp\Study\6 semestr\Kurs\Kurs\diagramscene.h", "C++", 62, 0, 0, 0, 51, 15, 128
"c:\Temp\Study\6 semestr\Kurs\Kurs\diagramsparqlatom.cpp", "C++", 33, 0, 0, 0, 0, 6, 39
"c:\Temp\Study\6 semestr\Kurs\Kurs\diagramsparqlatom.h", "C++", 18, 0, 0, 0, 0, 7, 25
"c:\Temp\Study\6 semestr\Kurs\Kurs\diagramtextitem.cpp", "C++", 30, 0, 0, 0, 57, 7, 94
"c:\Temp\Study\6 semestr\Kurs\Kurs\diagramtextitem.h", "C++", 29, 0, 0, 0, 51, 12, 92
"c:\Temp\Study\6 semestr\Kurs\Kurs\diagramview.cpp", "C++", 71, 0, 0, 0, 0, 13, 84
"c:\Temp\Study\6 semestr\Kurs\Kurs\diagramview.h", "C++", 37, 0, 0, 0, 0, 9, 46
"c:\Temp\Study\6 semestr\Kurs\Kurs\main.cpp", "C++", 11, 0, 0, 0, 0, 5, 16
"c:\Temp\Study\6 semestr\Kurs\Kurs\mainwindow.cpp", "C++", 718, 0, 0, 0, 174, 137, 1029
"c:\Temp\Study\6 semestr\Kurs\Kurs\mainwindow.h", "C++", 128, 0, 0, 0, 52, 19, 199
"c:\Temp\Study\6 semestr\Kurs\Kurs\mynetwork.cpp", "C++", 49, 0, 0, 0, 0, 13, 62
"c:\Temp\Study\6 semestr\Kurs\Kurs\mynetwork.h", "C++", 29, 0, 0, 0, 0, 7, 36
"c:\Temp\Study\6 semestr\Kurs\Kurs\outputwidget.cpp", "C++", 139, 0, 0, 0, 42, 23, 204
"c:\Temp\Study\6 semestr\Kurs\Kurs\outputwidget.h", "C++", 34, 0, 0, 0, 0, 9, 43
"c:\Temp\Study\6 semestr\Kurs\Kurs\scripts\XMLHttpRequest.js", "JavaScript", 0, 16, 0, 0, 0, 4, 20
"c:\Temp\Study\6 semestr\Kurs\Kurs\scripts\block_logic.js", "JavaScript", 0, 58, 0, 0, 1, 5, 64
"c:\Temp\Study\6 semestr\Kurs\Kurs\scripts\progress.js", "JavaScript", 0, 15, 0, 0, 0, 3, 18
"c:\Temp\Study\6 semestr\Kurs\Kurs\scripts\script.js", "JavaScript", 0, 19, 0, 0, 0, 7, 26
"c:\Temp\Study\6 semestr\Kurs\Kurs\sparqlblocksetting.cpp", "C++", 73, 0, 0, 0, 7, 14, 94
"c:\Temp\Study\6 semestr\Kurs\Kurs\sparqlblocksetting.h", "C++", 33, 0, 0, 0, 0, 11, 44
"c:\Temp\Study\6 semestr\Kurs\Kurs\sparqlblockwindow.cpp", "C++", 178, 0, 0, 0, 0, 29, 207
"c:\Temp\Study\6 semestr\Kurs\Kurs\sparqlblockwindow.h", "C++", 30, 0, 0, 0, 0, 8, 38
"c:\Temp\Study\6 semestr\Kurs\Kurs\virtualsetting.cpp", "C++", 4, 0, 0, 0, 0, 3, 7
"c:\Temp\Study\6 semestr\Kurs\Kurs\virtualsetting.h", "C++", 9, 0, 0, 0, 0, 4, 13
"c:\Temp\Study\6 semestr\Kurs\build-Kurs-GCC-Debug\Blocks\END.json", "JSON", 0, 0, -13, 0, 0, -1, -14
"c:\Temp\Study\6 semestr\Kurs\build-Kurs-GCC-Debug\Blocks\EnterNumber.json", "JSON", 0, 0, -13, 0, 0, -1, -14
"c:\Temp\Study\6 semestr\Kurs\build-Kurs-GCC-Debug\Blocks\Logic\AND-NOT.json", "JSON", 0, 0, -13, 0, 0, -1, -14
"c:\Temp\Study\6 semestr\Kurs\build-Kurs-GCC-Debug\Blocks\Logic\AND.json", "JSON", 0, 0, -13, 0, 0, -1, -14
"c:\Temp\Study\6 semestr\Kurs\build-Kurs-GCC-Debug\Blocks\Logic\EnterBoolean.json", "JSON", 0, 0, -13, 0, 0, -1, -14
"c:\Temp\Study\6 semestr\Kurs\build-Kurs-GCC-Debug\Blocks\Logic\NOT.json", "JSON", 0, 0, -13, 0, 0, -1, -14
"c:\Temp\Study\6 semestr\Kurs\build-Kurs-GCC-Debug\Blocks\Logic\OR-NOT.json", "JSON", 0, 0, -13, 0, 0, -1, -14
"c:\Temp\Study\6 semestr\Kurs\build-Kurs-GCC-Debug\Blocks\Logic\OR.json", "JSON", 0, 0, -13, 0, 0, -1, -14
"c:\Temp\Study\6 semestr\Kurs\build-Kurs-GCC-Debug\Blocks\Math\Multiplication.json", "JSON", 0, 0, -13, 0, 0, -1, -14
"c:\Temp\Study\6 semestr\Kurs\build-Kurs-GCC-Debug\Blocks\Math\Summary.json", "JSON", 0, 0, -13, 0, 0, -1, -14
"c:\Temp\Study\6 semestr\Kurs\build-Kurs-GCC-Debug\Blocks\OutputBlock.json", "JSON", 0, 0, -13, 0, 0, -1, -14
"c:\Temp\Study\6 semestr\Kurs\build-Kurs-GCC-Debug\Blocks\ะดัะด.json", "JSON", 0, 0, -13, 0, 0, -1, -14
"c:\Temp\Study\6 semestr\Kurs\build-Kurs-GCC-Debug\Logic\files.json", "JSON", 0, 0, -8, 0, 0, 0, -8
"c:\Temp\Study\6 semestr\Kurs\build-Kurs-GCC-Debug\Makefile", "Makefile", 0, 0, 0, -459, -7, -14, -480
"c:\Temp\Study\6 semestr\Kurs\build-Kurs-GCC-Debug\SPARQL\files.json", "JSON", 0, 0, -8, 0, 0, 0, -8
"c:\Temp\Study\6 semestr\Kurs\build-Kurs-GCC-Debug\SPARQL\test(v0.1).json", "JSON", 0, 0, -13, 0, 0, -1, -14
"c:\Temp\Study\6 semestr\Kurs\build-Kurs-GCC-Debug\debug\moc_api.cpp", "C++", -114, 0, 0, 0, -13, -18, -145
"c:\Temp\Study\6 semestr\Kurs\build-Kurs-GCC-Debug\debug\moc_basedblockwindow.cpp", "C++", -136, 0, 0, 0, -13, -18, -167
"c:\Temp\Study\6 semestr\Kurs\build-Kurs-GCC-Debug\debug\moc_compositeblockwindow.cpp", "C++", -116, 0, 0, 0, -10, -15, -141
"c:\Temp\Study\6 semestr\Kurs\build-Kurs-GCC-Debug\debug\moc_diagramscene.cpp", "C++", -199, 0, 0, 0, -16, -21, -236
"c:\Temp\Study\6 semestr\Kurs\build-Kurs-GCC-Debug\debug\moc_diagramtextitem.cpp", "C++", -145, 0, 0, 0, -12, -17, -174
"c:\Temp\Study\6 semestr\Kurs\build-Kurs-GCC-Debug\debug\moc_diagramview.cpp", "C++", -125, 0, 0, 0, -10, -15, -150
"c:\Temp\Study\6 semestr\Kurs\build-Kurs-GCC-Debug\debug\moc_mainwindow.cpp", "C++", -276, 0, 0, 0, -10, -15, -301
"c:\Temp\Study\6 semestr\Kurs\build-Kurs-GCC-Debug\debug\moc_mynetwork.cpp", "C++", -137, 0, 0, 0, -10, -15, -162
"c:\Temp\Study\6 semestr\Kurs\build-Kurs-GCC-Debug\debug\moc_outputwidget.cpp", "C++", -127, 0, 0, 0, -10, -15, -152
"c:\Temp\Study\6 semestr\Kurs\build-Kurs-GCC-Debug\debug\moc_predefs.h", "C++", -408, 0, 0, 0, 0, -1, -409
"c:\Temp\Study\6 semestr\Kurs\build-Kurs-GCC-Debug\debug\moc_sparqlblockwindow.cpp", "C++", -136, 0, 0, 0, -13, -18, -167
"c:\Temp\Study\6 semestr\Kurs\build-Kurs-GCC-Debug\debug\qrc_diagramscene.cpp", "C++", -18927, 0, 0, 0, -102, -19, -19048
"c:\Temp\Study\6 semestr\Kurs\build-Kurs-GCC-Debug\lol.json", "JSON", 0, 0, -85, 0, 0, -1, -86
"c:\Temp\Study\6 semestr\Kurs\build-Kurs-GCC-Debug\project.json", "JSON", 0, 0, -68, 0, 0, -1, -69
"c:\Temp\Study\6 semestr\Kurs\build-Kurs-GCC-Debug\test.json", "JSON", 0, 0, -68, 0, 0, -1, -69
"c:\Temp\Study\6 semestr\Kurs\build-Kurs-GCC-Debug\ui_basedblockwindow.h", "C++", -155, 0, 0, 0, -7, -47, -209
"c:\Temp\Study\6 semestr\Kurs\build-Kurs-GCC-Debug\ui_diagramview.h", "C++", -40, 0, 0, 0, -7, -15, -62
"c:\Temp\Study\6 semestr\Kurs\build-Kurs-GCC-Debug\ui_mainwindow.h", "C++", -43, 0, 0, 0, -7, -13, -63
"c:\Temp\Study\6 semestr\Kurs\build-Kurs-GCC-Debug\ui_outputwidget.h", "C++", -100, 0, 0, 0, -7, -25, -132
"Total", "-", -18271, 108, -406, -459, 492, 306, -18230