"filename", "language", "C++", "JavaScript", "comment", "blank", "total"
"c:\Temp\Study\6 semestr\Kurs\Kurs\api.cpp", "C++", 9, 0, 2, 5, 16
"c:\Temp\Study\6 semestr\Kurs\Kurs\api.h", "C++", 17, 0, 0, 7, 24
"c:\Temp\Study\6 semestr\Kurs\Kurs\arrow.cpp", "C++", 92, 0, 63, 18, 173
"c:\Temp\Study\6 semestr\Kurs\Kurs\arrow.h", "C++", 40, 0, 51, 11, 102
"c:\Temp\Study\6 semestr\Kurs\Kurs\basedblocksetting.cpp", "C++", 50, 0, 0, 14, 64
"c:\Temp\Study\6 semestr\Kurs\Kurs\basedblocksetting.h", "C++", 33, 0, 0, 6, 39
"c:\Temp\Study\6 semestr\Kurs\Kurs\basedblockwindow.cpp", "C++", 121, 0, 0, 17, 138
"c:\Temp\Study\6 semestr\Kurs\Kurs\basedblockwindow.h", "C++", 39, 0, 0, 14, 53
"c:\Temp\Study\6 semestr\Kurs\Kurs\compositeblocksetting.cpp", "C++", 11, 0, 0, 8, 19
"c:\Temp\Study\6 semestr\Kurs\Kurs\compositeblocksetting.h", "C++", 22, 0, 0, 6, 28
"c:\Temp\Study\6 semestr\Kurs\Kurs\compositeblockwindow.cpp", "C++", 173, 0, 3, 29, 205
"c:\Temp\Study\6 semestr\Kurs\Kurs\compositeblockwindow.h", "C++", 30, 0, 0, 7, 37
"c:\Temp\Study\6 semestr\Kurs\Kurs\diagramitem.cpp", "C++", 94, 0, 63, 19, 176
"c:\Temp\Study\6 semestr\Kurs\Kurs\diagramitem.h", "C++", 42, 0, 53, 11, 106
"c:\Temp\Study\6 semestr\Kurs\Kurs\diagramitembased.cpp", "C++", 83, 0, 0, 21, 104
"c:\Temp\Study\6 semestr\Kurs\Kurs\diagramitembased.h", "C++", 39, 0, 0, 7, 46
"c:\Temp\Study\6 semestr\Kurs\Kurs\diagramitemcomposite.cpp", "C++", 21, 0, 0, 4, 25
"c:\Temp\Study\6 semestr\Kurs\Kurs\diagramitemcomposite.h", "C++", 16, 0, 0, 7, 23
"c:\Temp\Study\6 semestr\Kurs\Kurs\diagramitemsparql.cpp", "C++", 46, 0, 2, 12, 60
"c:\Temp\Study\6 semestr\Kurs\Kurs\diagramitemsparql.h", "C++", 25, 0, 0, 7, 32
"c:\Temp\Study\6 semestr\Kurs\Kurs\diagramscene.cpp", "C++", 209, 0, 81, 25, 315
"c:\Temp\Study\6 semestr\Kurs\Kurs\diagramscene.h", "C++", 62, 0, 51, 15, 128
"c:\Temp\Study\6 semestr\Kurs\Kurs\diagramsparqlatom.cpp", "C++", 34, 0, 0, 7, 41
"c:\Temp\Study\6 semestr\Kurs\Kurs\diagramsparqlatom.h", "C++", 18, 0, 0, 7, 25
"c:\Temp\Study\6 semestr\Kurs\Kurs\diagramtextitem.cpp", "C++", 30, 0, 57, 7, 94
"c:\Temp\Study\6 semestr\Kurs\Kurs\diagramtextitem.h", "C++", 29, 0, 51, 12, 92
"c:\Temp\Study\6 semestr\Kurs\Kurs\diagramview.cpp", "C++", 72, 0, 0, 13, 85
"c:\Temp\Study\6 semestr\Kurs\Kurs\diagramview.h", "C++", 37, 0, 0, 9, 46
"c:\Temp\Study\6 semestr\Kurs\Kurs\main.cpp", "C++", 11, 0, 0, 5, 16
"c:\Temp\Study\6 semestr\Kurs\Kurs\mainwindow.cpp", "C++", 720, 0, 174, 136, 1030
"c:\Temp\Study\6 semestr\Kurs\Kurs\mainwindow.h", "C++", 128, 0, 52, 19, 199
"c:\Temp\Study\6 semestr\Kurs\Kurs\mynetwork.cpp", "C++", 49, 0, 0, 13, 62
"c:\Temp\Study\6 semestr\Kurs\Kurs\mynetwork.h", "C++", 29, 0, 0, 7, 36
"c:\Temp\Study\6 semestr\Kurs\Kurs\outputwidget.cpp", "C++", 105, 0, 81, 18, 204
"c:\Temp\Study\6 semestr\Kurs\Kurs\outputwidget.h", "C++", 34, 0, 0, 9, 43
"c:\Temp\Study\6 semestr\Kurs\Kurs\scripts\XMLHttpRequest.js", "JavaScript", 0, 16, 0, 4, 20
"c:\Temp\Study\6 semestr\Kurs\Kurs\scripts\block_logic.js", "JavaScript", 0, 58, 1, 5, 64
"c:\Temp\Study\6 semestr\Kurs\Kurs\scripts\progress.js", "JavaScript", 0, 15, 0, 3, 18
"c:\Temp\Study\6 semestr\Kurs\Kurs\scripts\script.js", "JavaScript", 0, 19, 0, 7, 26
"c:\Temp\Study\6 semestr\Kurs\Kurs\sparqlblocksetting.cpp", "C++", 73, 0, 7, 14, 94
"c:\Temp\Study\6 semestr\Kurs\Kurs\sparqlblocksetting.h", "C++", 33, 0, 0, 11, 44
"c:\Temp\Study\6 semestr\Kurs\Kurs\sparqlblockwindow.cpp", "C++", 195, 0, 0, 34, 229
"c:\Temp\Study\6 semestr\Kurs\Kurs\sparqlblockwindow.h", "C++", 33, 0, 0, 8, 41
"c:\Temp\Study\6 semestr\Kurs\Kurs\virtualsetting.cpp", "C++", 4, 0, 0, 3, 7
"c:\Temp\Study\6 semestr\Kurs\Kurs\virtualsetting.h", "C++", 9, 0, 0, 4, 13
"Total", "-", 2917, 108, 792, 625, 4442